a a a a a a a a a
a b b c c c c d a
a c c c c c c d a
a e f g g g g d a
a e f h g h g h a
a e f h h h h h a
a e f h h h h h a
f e f h i i i i h
f f f h h h h h h